██████████████████████████████████████████████████████████████████████
██  ██  ██  ██  ██  ██  ██  ██  ██  ██  ██  ██  ██  ██  ██  ██  ██  ██
██              ██                  ██                  ██      ██  ██
██████  ██████████████  ██  ██████  ██████  ██████  ██████  ██████  ██
██      ██          ██  ██  ██  ██          ██              ██  ██  ██
██████  ██████████  ██████████  ██████████  ██  ██  ██████  ██  ██  ██
██      ██  ██  ██  ██                  ██  ██  ██  ██              ██
██  ██████  ██  ██  ██████████████  ██████████████████████  ██████  ██
██  ██                                  ██      ██  ██          ██  ██
██  ██████████  ██  ██  ██████████████  ██████  ██  ██  ██████  ██████
██      ██  ██  ██  ██  ██      ██  ██                      ██  ██  ██
██  ██████  ██████████████  ██████  ██████  ██████  ██████  ██████  ██
            ██  ██  ██  ██              ██  ██      ██      ██  ██  ██
██  ██████  ██  ██  ██  ██████████  ██  ██████████████████  ██  ██  ██
██  ██  ██  ██  ██      ██      ██  ██      ██  ██          ██  ██  ██
██████  ██  ██  ██  ██  ██████  ██  ██████  ██  ██████████  ██  ██  ██
██  ██              ██          ██  ██              ██  ██  ██      ██
██  ██  ██████  ██████  ██████  ██████████████  ██████  ██  ██  ██████
██          ██      ██  ██                              ██      ██  ██
██████  ██████████████████████████  ██████████████████  ██  ██████  ██
██      ██          ██      ██  ██  ██                  ██  ██        
██████████████  ██████████  ██  ██████  ██████████████  ██  ██  ██████
██  ██                  ██      ██  ██  ██                          ██
██  ██████████  ██████████████  ██  ██████  ██  ██████  ██████  ██  ██
██      ██  ██  ██  ██                      ██      ██  ██      ██  ██
██████  ██  ██  ██  ██████  ██████  ██  ██████  ██  ██  ██████  ██  ██
██  ██                      ██  ██  ██  ██  ██  ██  ██  ██      ██  ██
██  ██  ██████████  ██  ██  ██  ██████  ██  ██  ██████  ██████████  ██
██      ██          ██  ██  ██  ██  ██  ██      ██  ██      ██      ██
██  ██████  ██████  ██  ██████  ██  ██████████  ██  ██  ██████████  ██
██  ██          ██  ██  ██                          ██  ██          ██
██  ██████  ██████████  ██████████████  ██████  ██  ██████  ██████  ██
██  ██      ██          ██              ██      ██      ██  ██      ██
██  ██  ██  ██  ██  ██  ██  ██  ██  ██  ██  ██  ██  ██  ██  ██  ██  ██
██████████████████████████████████████████████████████████████████████
